1111111111111
1P0C000000001
1000011111001
100011E000001
1111111111111