1111111111111
1P0X0000C0001
100000C000001
10000000000E1
1111111111111