1111111111111
1C010000000C1
1000011111001
1C0011E0C0P01
1111111111111